{
"name":"Matts Map",
"map":[
  [".", ".", ".", " ", ".", ".", ".", "."],
  [".", " ", ".", ".", ".", " ", " ", "P"],
  [".", " ", ".", " ", " ", " ", " ", " "],
  [".", " ", ".", " ", ".", ".", ".", "."],
  [".", " ", ".", ".", ".", " ", " ", "."],
  ["P", " ", ".", " ", ".", ".", " ", "G"]]}
