{
"name":"Shlomo's Map",
"map":[
["P",".",".",".",".",".",".",".",".",".",".",".",".","."," "," ",".",".",".",".",".",".",".",".",".",".",".",".",".","P"],
["."," "," "," "," ","."," "," "," "," "," "," "," ","."," "," ","."," "," "," "," "," "," "," ","."," "," "," "," ","."],
["0"," "," "," "," ","."," "," "," "," "," "," "," ","."," "," ","."," "," "," "," "," "," "," ","."," "," "," "," ","0"],
["."," "," "," "," ","."," "," "," "," "," "," "," ","."," "," ","."," "," "," "," "," "," "," ","."," "," "," "," ","."],
[".",".",".",".",".",".",".",".",".",".",".",".",".",".",".",".",".",".",".",".",".",".",".",".",".",".",".",".",".","."],
["."," "," "," "," ","."," "," "," "," "," "," "," ","."," "," ","."," "," "," "," "," "," "," ","."," "," "," "," ","."],
["."," "," "," "," ","."," "," "," "," "," "," "," ","."," "," ","."," "," "," "," "," "," "," ","."," "," "," "," ","."],
["."," "," "," "," ","."," "," "," "," "," "," "," ",".",".",".","."," "," "," "," "," "," "," ","."," "," "," "," ","."],
[".",".",".",".",".",".",".",".",".",".",".",".",".","."," ",".",".",".",".",".",".",".",".",".",".",".",".",".",".","."],
[" "," "," "," "," ","."," "," "," "," "," "," "," "," "," ","."," "," "," "," "," "," "," "," ","."," "," "," "," "," "],
[" "," "," "," "," ","."," "," "," "," "," "," "," "," "," ","."," "," "," "," "," "," "," "," ","."," "," "," "," "," "],
[" "," "," "," "," ","."," "," "," "," "," "," "," ","."," ",".","."," "," "," "," "," "," "," ","."," "," "," "," "," "],
[" "," "," "," "," ","."," "," "," "," "," "," "," ","G","G",".","G"," "," "," "," "," "," "," ","."," "," "," "," "," "],
[" "," "," "," "," ","."," "," "," "," "," "," "," ","G"," "," ","G"," "," "," "," "," "," "," ","."," "," "," "," "," "],
[" "," "," "," "," ","."," "," "," "," "," "," "," ","G"," "," ","G"," "," "," "," "," "," "," ","."," "," "," "," "," "],
[" "," "," "," "," ","."," "," "," "," "," "," "," ","G"," "," ","G"," "," "," "," "," "," "," ","."," "," "," "," "," "],
[" "," "," "," "," ","."," "," "," "," "," "," "," ","G","G","G","G"," "," "," "," "," "," "," ","."," "," "," "," "," "],
[" "," "," "," "," ","."," "," "," "," "," "," "," ","."," "," ","."," "," "," "," "," "," "," ","."," "," "," "," "," "],
[" "," "," "," "," ","."," "," "," "," "," "," "," "," "," "," "," "," "," "," "," "," "," "," ","."," "," "," "," "," "],
[" "," "," "," "," ","."," "," "," "," "," "," "," "," "," "," "," "," "," "," "," "," "," "," ","."," "," "," "," "," "],
[".",".",".",".",".",".",".",".",".",".",".",".",".","."," "," ",".",".",".",".",".",".",".",".",".",".",".",".",".","."],
["."," "," "," "," ","."," "," "," "," "," "," "," ","."," "," ","."," "," "," "," "," "," "," ","."," "," "," "," ","."],
["."," "," "," "," ","."," "," "," "," "," "," "," ","."," "," ","."," "," "," "," "," "," "," ","."," "," "," "," ","."],
["0",".","."," "," ",".",".",".",".",".",".",".",".","."," "," ",".",".",".",".",".",".",".",".","."," "," ",".",".","0"],
[" "," ","."," "," ","."," "," ","."," "," "," "," "," "," "," "," "," "," "," "," ","."," "," ","."," "," ","."," "," "],
[" "," ","."," "," ","."," "," ","."," "," "," "," "," "," "," "," "," "," "," "," ","."," "," ","."," "," ","."," "," "],
[".",".",".",".",".","."," "," ",".",".",".",".",".","."," "," ",".",".",".",".",".","."," "," ",".",".",".",".",".","."],
["."," "," "," "," "," "," "," "," "," "," "," "," ","."," "," ","."," "," "," "," "," "," "," "," "," "," "," "," ","."],
["."," "," "," "," "," "," "," "," "," "," "," "," ","."," "," ","."," "," "," "," "," "," "," "," "," "," "," "," ","."],
["P",".",".",".",".",".",".",".",".",".",".",".",".",".",".",".",".",".",".",".",".",".",".",".",".",".",".",".",".","P"]
]
}
