{
"name":"Shlomo's Map",
"map":[
[" "," "," "," "," "," "," "," "," "," "," "," "," "," "," "," "," "," "," "," "," "," "," "," "," "," "," "," "," "," "],
[" ","P",".",".",".",".",".",".",".",".",".",".",".","."," "," ",".",".",".",".",".",".",".",".",".",".",".",".","."," "],
[" ","."," "," "," "," ","."," "," "," "," "," "," ","."," "," ","."," "," "," "," "," "," ","."," "," "," "," ","."," "],
[" ","."," "," "," "," ","."," "," "," "," "," "," ","."," "," ","."," "," "," "," "," "," ","."," "," "," "," ","."," "],
[" ","."," "," "," "," ","."," "," "," "," "," "," ","."," "," ","."," "," "," "," "," "," ","."," "," "," "," ","."," "],
[" ",".",".",".",".",".",".",".",".",".",".",".",".",".",".",".",".",".",".",".",".",".",".",".",".",".",".",".","."," "],
[" ","."," "," "," "," ","."," "," ","."," "," "," "," "," "," "," "," "," "," ","."," "," ","."," "," "," "," ","."," "],
[" ","."," "," "," "," ","."," "," ","."," "," "," "," "," "," "," "," "," "," ","."," "," ","."," "," "," "," ","."," "],
[" ",".",".",".",".",".","."," "," ",".",".",".",".","."," "," ",".",".",".",".","."," "," ",".",".",".",".",".","."," "],
[" "," "," "," "," "," ","."," "," "," "," "," "," ","."," "," ","."," "," "," "," "," "," ","."," "," ","."," "," "," "],
[" "," "," "," "," "," ","."," "," "," "," "," "," ","."," "," ","."," "," "," "," "," "," ","."," "," ","."," "," "," "],
[" "," "," "," "," "," ","."," "," "," "," ",".",".",".",".",".",".",".","."," "," "," "," ","."," "," ","."," "," "," "],
[".",".",".",".",".",".",".",".","."," "," ","."," "," ",".","."," "," ",".",".",".","."," ","."," "," ","."," "," "," "],
[" "," "," ","."," "," ","."," ","."," "," ","."," ",".",".",".","."," ","."," "," ","."," ","."," "," ","."," "," "," "],
[" "," "," ","."," "," ","."," ","."," "," ","."," ","G",".",".","G"," ","."," "," ","."," ","."," "," ","."," "," "," "],
[" "," "," ","."," "," ","."," ","."," "," ","."," ","G",".",".","G"," ","."," "," ","."," ","."," "," ","."," "," "," "],
[" "," "," ","."," "," ","."," ",".",".",".","."," "," "," "," "," "," ","."," "," ",".",".",".",".",".",".",".",".","."],
[" "," "," ","."," "," ","."," "," "," "," ",".",".",".",".",".",".",".","."," "," "," "," ","."," "," "," "," "," "," "],
[" "," "," ","."," "," ","."," "," "," "," ","."," "," "," "," "," "," ","."," "," "," "," ","."," "," "," "," "," "," "],
[" ",".",".",".",".",".",".",".",".",".",".",".",".","."," "," ",".",".",".",".",".",".",".",".",".",".",".",".","."," "],
[" ","."," "," "," "," ","."," "," "," "," "," "," ","."," "," ","."," "," "," "," "," "," ","."," "," "," "," ","."," "],
[" ","."," "," "," "," ","."," "," "," "," "," "," ","."," "," ","."," "," "," "," "," "," ","."," "," "," "," ","."," "],
[" ",".",".","."," "," ",".",".",".",".",".",".",".","."," "," ",".",".",".",".",".",".",".","."," "," ",".",".","."," "],
[" "," "," ","."," "," ","."," "," "," ","."," "," "," "," "," "," "," "," ","."," "," "," ","."," "," ","."," "," "," "],
[" "," "," ","."," "," ","."," "," "," ","."," "," "," "," "," "," "," "," ","."," "," "," ","."," "," ","."," "," "," "],
[" ",".",".",".",".",".","."," "," "," ",".",".",".","."," "," ",".",".",".","."," "," "," ",".",".",".",".",".","."," "],
[" ","."," "," "," "," "," "," "," "," "," "," "," ","."," "," ","."," "," "," "," "," "," "," "," "," "," "," ","."," "],
[" ","."," "," "," "," "," "," "," "," "," "," "," ","."," "," ","."," "," "," "," "," "," "," "," "," "," "," ","."," "],
[" ",".",".",".",".",".",".",".",".",".",".",".",".",".",".",".",".",".",".",".",".",".",".",".",".",".",".",".","P"," "],
[" "," "," "," "," "," "," "," "," "," "," "," "," "," "," "," "," "," "," "," "," "," "," "," "," "," "," "," "," "," "]
]
}
